XXXXXXXXXXXXXXXXXXXXXXXXXXXXXXXXXXXXXXXXXX
X3212321211232232111X11111111111123211112X
X22X222211321232121111232111121X122211b21X
X1232232111X111111XXXXXXXXXXXXXX112111111X
X12111X2111XXXXX11233XX21XX1111X111111211X
X1X112X1a11XXXXX222111X121X11221222212112X
XXX21XX1111X1111112112X2121XXXXX111111111X
X3212321211232232111X11111111111123211112X
X2221112111X2111XXXXX11233XX121X1122122d2X
X11X112X122X1223132332X2121XXXXX111111111X
XXX21XX1111X111111211121123X232111X111113X
X1232232111X111111XXXXXXXXXXXXXX112111111X
X12111X2111XXXXX11233XX21XX1111X111111211X
X1X112X1c11XXXXX222111X121X11221222212112X
XXX21XX1111X1111112112X2121XXXXX111111111X
XXXXXXXXXXXXXXXXXXXXXXXXXXXXXXXXXXXXXXXXXX